#######################
#..#.............#..E.#
#.H###...........#E.E.#
#....H...........##..E#
##H........####.......#
###..H.....#..........#
#######################